⠀⠀⠀⠀⠀⠀⠀⠀⠀⠀⠀⠀⠀⠀⠀⠀⠀⠀⠀⠀⠀⠀⠀⠀⠀⠀⣤⠀⠀⠀⠀⠀⠀⠀⠀⠀⠀⠀⠀⠀⠀⠀⠀⠀⠀⠀⠀⠀⠀⠀
⠀⠀⠀⠀⠀⠀⠀⠀⠀⠀⠀⠀⠀⠀⠀⠀⠀⠀⠀⠀⠀⠀⠀⠀⢠⡞⡟⠀⠀⠀⠀⠀⠀⠀⠀⠀⠀⠀⠀⠀⠀⠀⠀⠀⠀⠀⠀⠀⠀⠀
⠀⠀⠀⠀⠀⠀⠀⠀⠀⠀⠀⠀⠀⠀⠀⠀⠀⠀⠀⠀⠀⠀⠀⣰⠋⠀⡇⠀⠀⠀⠀⠀⠀⠀⠀⠀⠀⠀⠀⠀⠀⠀⠀⠀⠀⠀⠀⠀⠀⠀
⠀⠀⠀⠀⠀⠀⠀⠀⠀⠀⠀⠀⠀⠀⠀⠀⠀⠀⠀⠀⠀⢀⡾⠁⠀⠀⣇⠀⠀⠀⠀⠀⠀⠀⠀⠀⠀⠀⠀⠀⠀⠀⠀⠀⠀⠀⠀⠀⠀⠀
⠀⠀⠀⠀⠀⠀⠀⠀⠀⠀⠀⠀⠀⠀⠀⠀⠀⠀⠀⠀⣴⠋⠀⠀⡀⠀⣿⠀⠀⠀⠀⠀⠀⠀⠀⠀⠀⣠⣴⠄⠀⠀⠀⠀⠀⠀⠀⠀⠀⠀
⠀⠀⠀⠀⠀⠀⠀⠀⠀⠀⠀⠀⠀⠀⠀⠀⠀⠀⣠⠞⠁⠀⠀⣼⡇⠀⣿⠀⠀⠀⠀⠀⠀⢀⣠⣴⠛⣷⡏⠀⠀⠀⠀⠀⠀⠀⠀⠀⠀⠀
⠀⠀⠀⠀⠀⠀⠀⠀⠀⠀⠀⠀⠀⠀⠀⠀⣠⠞⠁⠀⠀⢀⡼⣹⠁⠀⡟⠀⠀⣀⣤⠴⢾⠉⡟⠸⡇⡾⠀⠀⠀⠀⠀⠀⠀⠀⠀⠀⠀⠀
⠀⠀⠀⠀⠀⠀⠀⠀⠀⠀⠀⠀⠀⠀⣠⠞⠁⠀⠀⠀⢀⡞⢁⡟⠀⢠⡇⡖⢻⠁⢴⠀⢸⠀⡇⠀⡿⠁⠀⠀⠀⠀⠀⠀⠀⠀⠀⠀⠀⠀
⠀⠀⠀⠀⠀⠀⠀⠀⠀⠀⠀⠀⣠⠞⠁⠀⠀⠀⠀⢀⡞⠀⡼⠁⠀⣼⢹⡆⢸⡀⢸⠀⢸⠀⣇⣼⠃⠀⠀⠀⠀⠀⠀⠀⠀⠀⠀⠀⠀⠀
⠀⠀⠀⠀⠀⠀⠀⠀⠀⠀⠀⣼⠃⠀⠀⠀⠀⠀⠀⣼⢁⡼⠁⠀⣰⠻⡄⣇⠈⣇⠈⡇⢸⡄⡽⠁⠀⠀⠀⠀⠀⠀⠀⠀⠀⠀⠀⠀⠀⠀
⠀⠀⠀⠀⠀⠀⠀⣰⣆⠀⢸⠃⠀⠀⠀⠀⠀⠀⠀⢉⣽⠞⠋⠉⠉⠙⠻⣽⡤⣿⠀⢷⣈⡿⠁⠀⠀⠀⠀⠀⠀⠀⠀⠀⠀⠀⠀⠀⠀⠀
⠀⠀⠀⠀⠀⠀⠀⡏⠘⣦⡏⠀⠀⠀⠀⠀⠀⠀⣴⠏⠀⠀⠀⠀⢀⡴⠒⠻⡿⣿⣇⡼⠋⠀⠀⠀⠀⠀⠀⠀⠀⠀⠀⠀⠀⠀⠀⠀⠀⠀
⠀⠀⠀⠀⠀⠀⢸⠇⠀⠘⠃⠀⠀⠀⠀⠀⠀⡼⠁⠀⠀⠀⠀⣴⠋⢀⡴⠚⢳⠸⣇⠀⠀⠀⠀⠀⠀⠀⠀⠀⠀⠀⠀⠀⠀⠀⠀⠀⠀⠀
⠀⠀⠀⠀⠀⠀⢸⠀⠀⠀⠀⠀⠀⠀⠀⠀⣼⠃⠀⠀⠀⠀⣼⠃⠀⠘⠧⠴⠟⠀⠈⢳⡀⠀⠀⠀⠀⠀⢸⡇⠀⠀⠀⠀⠀⠀⠀⠀⠀⠀
⠀⠀⠀⠀⢠⡴⠞⠀⠰⣶⠖⠒⠋⠀⠀⢰⡇⣀⣀⣀⠀⡼⠁⠀⢀⣤⣶⣦⣄⠀⠀⠀⠙⢦⡀⠀⠀⠀⠘⣷⣤⣄⣴⣦⠀⣴⡦⢠⠒⢂
⠀⠀⠀⠀⠀⠙⠦⣄⡀⢈⣹⢶⡟⠓⢲⡾⠋⠁⠀⠈⢻⠇⠀⢰⣿⣿⣿⣿⣿⣧⡀⠀⠀⠀⠙⢦⡀⠀⠈⠻⠶⠟⠻⠿⠌⠻⠆⢸⠒⠃
⠀⠀⠀⠀⠀⣠⠴⢛⡽⠋⠁⣼⠀⢰⠏⠀⠀⠀⠀⠀⠈⢷⠀⢈⡻⠿⠿⣿⣿⣿⣷⠀⠀⠀⠀⠀⠉⠳⣤⠀⠀⠀⠀⠀⠀⠀⠀⠸⠀⠀
⠀⠀⢀⡴⠞⠁⢶⡋⠀⠀⠀⠹⡄⢻⠀⠀⠀⠀⠀⠀⠀⢈⡇⠈⠿⢷⠀⠀⠀⠀⠁⠀⠀⠰⣦⣤⠀⣴⠃⠀⠀⠀⠀⠀⠀⠀⠀⠀⠀⠀
⠐⠾⣏⡀⠀⠀⠀⠙⢦⡀⠀⠀⠙⢾⣧⡀⠀⠀⠀⠀⢀⡞⠁⠀⠀⠘⣇⣀⡤⠖⢦⠀⠀⠀⠀⢀⡼⠃⠀⠀⠀⠀⠀⠀⠀⠀⠀⠀⠀⠀
⠀⠀⠀⢉⡷⠆⠀⠀⠀⠉⠓⠤⢤⣤⣬⠙⠳⠦⠴⠚⠉⠙⠒⠦⢤⣀⣀⠀⠀⠀⠈⠓⠶⠶⣤⠟⠀⠀⠀⠀⠀⠀⠀⠀⠀⠀⠀⠀⠀⠀
⠀⠰⣾⡉⠀⠀⠀⠀⠀⠀⠀⠀⠀⠀⣿⠀⢀⡤⠴⠒⠚⠛⠛⠃⠀⠀⣽⠉⠙⠓⠒⠒⠒⠚⠁⠀⠀⠀⠀⠀⠀⠀⠀⠀⠀⠀⠀⠀⠀⠀
⠀⠀⠀⠙⠳⢤⣀⣀⡀⠀⠀⠀⠀⠀⠘⠟⠁⠀⠀⠀⠀⠀⠀⠀⠀⠀⠙⠳⠶⢺⡇⠀⠀⠀⠀⠀⠀⠀⠀⠀⠀⠀⠀⠀⠀⠀⠀⠀⠀⠀
⠀⠀⠀⠀⠀⠀⣠⠟⠁⠀⠀⠀⠀⠀⠀⠀⠀⠀⠀⠀⠀⠀⠀⠀⠀⠀⠀⣤⣴⡋⠀⠀⠀⠀⠀⠀⠀⠀⠀⠀⠀⠀⠀⠀⠀⠀⠀⠀⠀⠀
⠀⠀⠀⠀⢀⣾⣁⣀⠀⠀⠀⠀⠀⠀⠀⠀⠀⠀⠀⠀⠀⠀⠀⠀⠀⠀⠀⠀⠀⠉⠳⣦⠀⠀⠀⠀⠀⠀⠀⠀⠀⠀⠀⠀⠀⠀⠀⠀⠀⠀
⠀⠀⠀⠀⠀⠉⠉⣽⠃⠀⠀⠀⠀⠀⠀⠀⠀⠀⠀⠀⠀⠀⠀⠀⠀⠀⠀⠀⣤⣤⣀⣈⣷⠀⠀⠀⠀⠀⠀⠀⠀⠀⠀⠀⠀⠀⠀⠀⠀⠀
⠀⠀⠀⠀⠀⠀⠀⠿⠞⠁⠘⠒⠦⢤⣀⡀⠀⠀⠀⠀⠀⠀⠀⠀⠀⠀⠀⠀⠙⣆⠀⠀⠀⠀⠀⠀⠀⠀⠀⠀⠀⠀⠀⠀⠀⠀⠀⠀⠀⠀
⠀⠀⠀⠀⠀⠀⠀⠀⠀⠀⠀⠀⠀⠀⠀⠉⠓⠦⢤⣀⠀⠀⠀⠀⠀⠀⠀⡀⠀⠈⢧⠀⠀⠀⠀⠀⠀⠀⠀⠀⠀⠀⠀⠀⠀⠀⠀⠀⠀⠀
⠀⠀⠀⠀⠀⠀⠀⠀⠀⠀⠀⠀⠀⠀⠀⠀⠀⠀⠀⠈⠙⠒⠦⣄⡀⠀⠀⢻⡙⠓⠛⠀⠀⠀⠀⠀⠀⠀⠀⠀⠀⠀⠀⠀⠀⠀⠀⠀⠀⠀
⠀⠀⠀⠀⠀⠀⠀⠀⠀⠀⠀⠀⠀⠀⠀⠀⠀⠀⠀⠀⠀⠀⠀⠀⠉⠓⠦⣄⣷⠀⠀⠀⠀⠀⠀⠀⠀⠀⠀⠀⠀⠀⠀⠀⠀⠀⠀⠀⠀⠀
⠀⠀⠀⠀⠀⠀⠀⠀⠀⠀⠀⠀⠀⠀⠀⠀⠀⠀⠀⠀⠀⠀⠀⠀⠀⠀⠀⣈⡙⠁⠀⠀⠀⠀⠀⠀⠀⠀⠀⠀⠀⠀⠀⠀⠀⠀⠀⠀⠀⠀
